C01-1-0-1-1
C02-0-0-0-1
C03-0-0-1-1
C04-0-0-0-1
C09-0-1-1-0
C08-1-0-0-1
